5,0,0,0,0,0,0,0,0,0,0,0,0
3,7,4,0,0,0,0,1,7,0,0,0,4
0,1,0,0,0,0,0,5,2,0,12,8,9
0,0,0,4,0,0,0,0,0,0,17,2,0
8,9,10,11,13,0,0,0,0,4,18,0,0
0,0,0,0,16,0,0,12,8,10,14,0,0
0,1,7,2,17,1,0,16,4,0,0,0,0
5,6,4,0,15,10,11,14,0,0,0,3,0
0,0,0,0,0,0,0,0,0,0,6,2,1
0,0,0,0,0,0,0,0,0,0,0,0,0
