00000000000000
00000000000000
s1111111111110
00000000000010
0000e111100010
00000000100010
00001111100010
00001000000010
00001000000010
00001000000010
00001111111110
00000000000000
00000000000000
00000000000000